 ###########
##         ##
#  @     @  #
# @# #o# #@ #
#    #@#    #
#  ###o###  #
#  o@oA0@o  #
#  ### ###  #
#    #o#    #
# @# #@# #@ #
#  @ #o# @  #
##         ##
 ###########