      ###
      # #
      # #
  ##### #####
 ##         ##
##  # # # #  ##
#  ##     ##  #
# ##  @A@  ## #
####  ###  ####
   #### ####