############
#oo  #     ###
#oo  # @  @  #
#oo  #@####  #
#oo    A ##  #
#oo  # # @ ##
###### ##@ @ #
  #  @ @ @ @ #
  #    #     #
  ############